#.......O
.........
.........
.........
.S.......
.....#...
.........
....#....
....#....