...######
...#.....
.........
.....O#..
#........
##.......
###.....#
####S..##
#########