.........
.........
..#####..
..#..O#..
..#......
..#......
..#######
.........
........S