#........
#........
#.#####..
#.#####..
...S#O...
..#####.#
..#####.#
........#
........#