#########
#S......#
#.......#
#.......#
####....#
####....#
####....#
####O...#
#########