.....####
.....####
.....####
.........
........S
.........
####...##
####...##
####O..##