##...S###
##....###
.........
...#.....
...#O....
..###.#.#
........#
........#
######.##