.......##
.........
#.#......
#....##..
#O....#.S
#.....#..
#..#.....
.........
.........