#########
#########
#########
#.......#
#S.....O#
#.......#
#########
#########
#########