###...###
........#
...O#...#
..###....
.........
#....###.
#....#...
#S...#...
###......